Level 15 (18)
Ground
1111111111111111111
11K22222222222222C1
112222222222222p221
11111222S2222222221
1111121pS2222222121
111P2212S2222222121
1111111222222222221
111T221222222222221
11111L1222222222121
11111SS222122222121
1222S22222122222121
1211S21222222222221
1211SS2222222222121
1222S21122112212221
1111111111111111111
Time
0 35
Done