Level 1
Ground
0000000000000000000
0000000000000000000
0000000000000000000
0000000000000000000
0000000000000000000
0000000000000000000
0000000000000000000
0000000000000000000
0000000000000000000
0111111111111111100
01T222222222222P100
0111111111111111100
0000000000000000000
0000000000000000000
0000000000000000000
Time
0 8
Done