Level 3
Ground
0000000000000000000
0000000000000000000
0000000000000000000
0000000000000000000
0000000000000000000
0000000000000000000
0011100000000111000
001T1000000001P1000
0012111110000121000
0012112211111121000
0012222222222221000
0012211112211221000
0011110011111111000
0000000000000000000
0000000000000000000
Time
0 10
Done