Level 13(15)
Ground
1111111111111111111
1222222221SS1SS2221
1212222222SSSS21221
1222122222SSSS21L11
1222222222SSSS212T1
122222SSSCS22221111
122222S2SSS22222221
122222S222222222221
11SSS2222222S222221
1KSSSS2222222222221
1221222222222211221
1222222222222211111
12121P1212222222221
1222111222222222221
1111111111111111111
Time
0 30
Done