Level 4
Ground
0000000000000000000
0111110000001111100
0122211111111222100
0121211222211212100
0122222222222222100
0112111122111121100
0012101222210121000
001P101C222101T1000
0011101111110111000
0000000000000000000
0000000000000000000
0000000000000000000
0000000000000000000
0000000000000000000
0000000000000000000
Time
0 12
Done