Level 12 (13)
Ground
0000000111101110000
0011111122111210000
001221222S22SS10000
0012222222112210000
0012111222222211000
00121111111SSS21000
001S2222222S2211000
001212112C2SSS10000
1112121222222S10000
1K121212222SSS10000
1S121211111S2111110
1S12S21T2L2S112P210
1S11S111111222S2210
1SSSS10000111111110
1111110000000000000
Time
0 27
Done