Level 2
Ground
0000000000000000000
0000000000000000000
0000000000000000000
0000000000000000000
0000000000000000000
0000000000000000000
0000000000000111000
00000000000001T1000
0000000000000121000
0111111101111121000
01P2222101222221000
0111112111211111000
0000012222210000000
0000011111110000000
0000000000000000000
Time
0 8
Done