Level 5
Ground
0000000000000000000
0000000000000000000
0000000000000000000
0000000000000000000
0000000000000000000
0000000000000000000
0000000000000111000
00000000000001P1000
0001111111111121110
0111222222222222210
01T2222222C22222210
0111122222222222210
0000111111111111110
0000000000000000000
0000000000000000000
Time
0 13
Done